#############
# .. .. G.. #
# ## #.  .  #
#. P.#.  .  #
# . #..  ...#
#     .##   #
#     . #   #
#   G . ##  #
#######..   #
# ..        #
#############
